  ######
###.&.# 
# BB#B##
#      #
### .  #
  # X  #
  ######