 ## #####
## ## . #
# ## B. #
 ## B   #
## B& ###
# B  ##  
#.. ## ##
#   # ## 
##### #  