#########
#&      #
#       #
# BBB...#
#    ####
#    ####
#########